BBBBBBBBBBBBB
BPEEEEEEEEEPB
BEWEWEWEWEWEB
BEEIEEEEEIEEB
BEWEWEWEWEWEB
BEEEEEEEEEEEB
BEWEWEWEWEWEB
BEEEEEEEEEEEB
BEWEWEWEWEWEB
BEEIEEEEEIEEB
BEWEWEWEWEWEB
BPEEEEEEEEEPB
BBBBBBBBBBBBB