BBBBBBBBBBBBB
BPREEEEEEERPB
BRWEWEWEWEWRB
BEEIEEEEEIEEB
BEWEWEWEWEWEB
BEEEEEEEEEEEB
BEWEWEWEWEWEB
BEEEEEEEEEEEB
BEWEWEWEWEWEB
BEEIEEEEEIEEB
BRWEWEWEWEWRB
BPREEEEEEERPB
BBBBBBBBBBBBB